#########
#       #
# P   O #
#       ######
#  X      O  #
#           ##
#     X     #
#        ####
#  X   O    #
#############
